##############
#S..B...#....#
#..###B.....##
#..###...#...#
##..#....#...#
###....#....G#
##############
