#############
#S......#...#
#..###.....##
##..#....#..#
###....#...G#
#############
