##############
#S......#....#
#..###.B....##
##..#....#...#
###....#....G#
##############
