########
##S.#..#
#.B..B.#
#..#..##
#....B.#
#.#.G..#
#..#.B.#
########
