##########
#..#.....#
#.......G#
#......#.#
#S#..#...#
##########