#########
#S......#
##..#...#
#..G.#..#
#.......#
#...B...#
#..#....#
#########